1111111111111
1001000000001
100010E001001
100011000001
1111111111111

NO                 ./pics/NO.xpm
        SO              ./pics/SO.xpm


WE ./pics/WE.xpm

F 220,100,0
        EA ./pics/EA.xpm


C    225,30,0