NO                 ./pics/NO.xpm
        SO              ./pics/SO.xpm


WE ./pics/WE.xpm

F 220,100,0
        EA ./pics/EA.xpm

C     225,30,50

  11111111111111111111111111
    1000000000110000000010001
   1110111000001110000000000011
  100100000000000000000000111111
111111111011000001110000000000001
10000000001100000111011111111111
11110111111111011100000010001
1111011111111101111010010001
1000000110101011100000010001
100000000000011000000100011
1000100000W00001101010010001
1100000111010101111101111000111
11110111 1110101101111010001
11111111 1111111 11111111111111



