NO                 ./pics/NO.xpm
        SO              ./pics/SO.xpm


WE ./pics/WE.xpm

F 220,100,0
        EA ./pics/EA.xpm


C    225,30,0
  11111111111111111111111111
    1000000000110000000010001
    101100000111000000000001
    1001000000000000000000001
111111111011000001110000000000001
100000000011000001110111111111111
11110111111111011100000010001
11110111111111011101010010001
11000000110101011100000010001
1001W000000000001100000010001
1000100000000001101010010001
1100000111010101111101111000111
11110111 1110101 101111010001
11111111 1111111 1111111111111

